AAAAAAAAAAAAAAAAAAA
APPPPPPPPAPPPPPPPPA
AOAAPAAAPAPAAAPAAOA
APPPPPPPPPPPPPPPPPA
APAAPAPAAAAAPAPAAPA
APPPPAPPPAPPPAPPPPA
AAAAPAAAPAPAAAPAAAA
AAAAPABBBBBBBAPAAAA
AAAAPABAABAABAPAAAA
BBBBPBBABBBABBPBBBB
AAAAPABAAAAABAPAAAA
AAAAPABBBBBBBAPAAAA
AAAAPAAAPAPAAAPAAAA
APPPPAPPPAPPPAPPPPA
APAAPAPAAAAAPAPAAPA
APPPPPPPPPPPPPPPPPA
AOAAPAAAPAPAAAPAAOA
APPPPPPPPAPPPPPPPPA
AAAAAAAAAAAAAAAAAAA