BBBBBBBBBBBBBBBBBBBBBBBBBBBBBBB
BBBBBBBBBBBBBBBBBBBBBBBBBBBBBBB
BBBBBBBBBBBBBBBBBBBBBBBBBBBBBBB
BBBBBBBBBBBBBBBBBBBBBBBBBBBBBBB
BBBBBBBBBBBBBBBBBBBBBBBBBBBBBBB
BBBBBAAAAAAAAAAAAAAAAAAAAABBBBB
BBBBBAAAAAAAAAAAAAAAAAAAAABBBBB
BBBBBAAPPPPPPPPAPPPPPPPPAABBBBB
BBBBBAAOAAPAAAPAPAAAPAAOAABBBBB
BBBBBAAIPPIPIPIPIPIPIPPIAABBBBB
BBBBBAAPAAPAPAAAAAPAPAAPAABBBBB
BBBBBAAPPPIAPPPAPPPAIPPPAABBBBB
BBBBBAAAAAPAAAPAPAAAPAAAAABBBBB
BBBBBAAAAAPABBiBiBBAPAAAAABBBBB
BBBBBAAAAAPABAABAABAPAAAAABBBBB
BBBBBABBBBIBiABBBAiBIBBBBABBBBB
BBBBBAAAAAPABAAAAABAPAAAAABBBBB
BBBBBAAAAAPABBiBiBBAPAAAAABBBBB
BBBBBAAAAAPAAAPAPAAAPAAAAABBBBB
BBBBBAAPPPIAPPPAPPPAIPPPAABBBBB
BBBBBAAPAAPAPAAAAAPAPAAPAABBBBB
BBBBBAAIPPIPIPIPIPPPIPPIAABBBBB
BBBBBAAOAAPAAAPAPAAAPAAOAABBBBB
BBBBBAAPPPIPPPPAPPPPIPPPAABBBBB
BBBBBAAAAAAAAAAAAAAAAAAAAABBBBB
BBBBBAAAAAAAAAAAAAAAAAAAAABBBBB
BBBBBBBBBBBBBBBBBBBBBBBBBBBBBBB